AACAAC	AAC
AAGAAG	AAG
AATAAT	AAT
ACAC	AC
ACACAC	AC
ACTACT	ACT
AGAG	AG
AGAGAG	AG
AGCAGC	AGC
AGGAGG	AGG
AGTAGT	AGT
ATAT	AT
ATATAT	AT
ATCATC	ATC
ATGATG	ATG
ATTATT	ATT
CCGCCG	CCG
CCTCCT	CCT
CGCG	CG
CGCGCG	CG
CGTCGT	CGT
CTCT	CT
CTCTCT	CT
CTGCTG	CTG
CTTCTT	CTT
GTGT	GT
GTGTGT	GT
GTTGTT	GTT
